11101111101111111110
00101000100010000010
10101010111011111010
10101010001000001010
10111011101110111010
10000010100010000010
11111110111011111010
10100000000000001010
10101111111110111010
10101000000010100010
10101011111010101110
10001010001010100010
11111010111010111010
10000010100010001010
10111110101011101010
10001010101000101010
11101010101110111010
00100010101010000010
11111110111011111110
00000000000000000010
