10111111101111111110
10100010101010000010
10101010101010111110
10101010100010100000
10101010111010111110
10101010001010000000
10111011101011111110
10001000101000001010
11101110101011101010
00100010101010100010
10111010101010111010
10001000101010001010
11101110101010101010
10100010101010101010
10111110101010101010
10000000101010101010
11101111101010101110
00101000001010100010
11111011111110111110
00000000000000000010
