10111011111110111110
10101010001010100010
10101011101010101010
10101000101010101010
10101110101010111010
10100010101010000010
11101110101011101110
00001000001000101010
11101011101010101010
10101010101010101010
10101010111010111010
10001010000010000010
11101010111111111110
10101010100000000000
10101110111011101110
10100000001010101010
10101111101010111010
10101010001010000010
10111011111110111110
00000000000000000010
